####################
#@................##
#.#................#
#...............#..#
#...#..............#
#.............#....#
#.....#............#
#...........#......#
#.......#..........#
##.................#
##.......0.........#
#..........#.......#
#......#...........#
#............#.....#
#....#.............#
#..............#...#
#..#...............#
#................#.#
#..................#
####################