####################
#@..#..............#
#...#..............#
#...............#..#
#..................#
#..................#
#..................#
#.....#.......#....#
#..................0
#..................#
#..................#
#..................#
#....#.............#
#..............#...#
#..................#
#..................#
#..................#
#..............#...#
#..#...............#
####################