####################
#......#...#.......#
############.#.#####
#......#.........#.#
########.###.#.#.#.#
#.........#........#
#.######..##.#.###.#
#.#@.............#.#
#.######..##.#.#.#.#
#.##...#.....#.#.#.#
#.#..............#.#
#.#..#.#.....#.###.#
#.#..#.............#
#.####.0..##.#.###.#
#....#....#..#.....#
####.##..##..#######
#..#.....#.........#
#######.##.#.#####.#
#.....#....#.......#
####################