####################
#@....#.........#..#
#...#.......#......#
#......#.........#.#
#............#.....#
#....#...#......#..#
##...........#.....#
#...#..........#...#
########.###########
#..................#
#...#...#......#...#
#.....#...#.......##
#.#...........#....#
#........#.........#
#.#............#...#
#......#..#........#
#..#..........#....#
#........#.#.....#.#
#...#0#............#
####################