####################
#@..#..............#
#..#...............#
##..#..............#
#.#..#.............#
#......#...........#
#........#.........#
#.....#...#........#
#...........#......#
#............#.....#
#..........#..######
#...........#.....0#
#........#...#######
#..........#.......#
#.........#........#
#...#...#..........#
#.....#............#
#....#.............#
#..#...............#
####################