####################
#..#...............#
#..#..############.#
#...#..##........#.#
#.#..#..#..#####.#.#
#.##..#..#..#0.#.#.#
#.#.#..#..#..#.#.#.#
#.#..#..#..#...#.#.#
#.##..#..#..#..#.#.#
#.#.#..#..#..###.#.#
#.#..#..#..#..##.#.#
#.#...#..#..#..#.#.#
#.#.#..#..#..#...#.#
#.#..#..#..#..#..#.#
#.##..#..#..#..###.#
#.#.#..#..#..#..##.#
#.#..#..#..#..#..#.#
#.#...#..#..#..#...#
#...#.....#.@#..#..#
####################